****************************************************************
*2222222222222222222222222222222222222222222222222222222222*   *
*2222222222222222222222222222222222222222222222222222222222*   *
*2222222222222222222222222222122222222222222222222222222222*   *
*2222222222222222222222222222112222222222222222222222222222*   *
*2222**********************1111************************1111*   *
*2222*                    *1111*                      *1111*   *
*2222*                    *1111*                      *2222*   *
*2222*                    *2222*                      *2222*   *
*2222*                    *2222*                      *2222*   *
*2222*                    *2222*                      *2222*   *
*2222*                    *2222*                      *2222*   *
*2222*                    *2222*                      *2222*   *
*2222*                    *2222*                      *2222*   *
*2222*                    *2222*                      *2222*   *
*2222*                    *2222*                      *2222*   *
*2222*                    *2222*                      *2222*   *
*2222*                    *2222*                      *2222*   *
*2222*                    *2222*                      *2222*   *
*2222*                    *2222*                      *2222*   *
*2222*                    *2222*                      *2222*   *
*2222*                    *2222*                      *2222*   *
*2222*                    *2222*                      *2222*   *
*2222*                    *2222*                      *2222*   *
*2222*                    *1111*                      *2222*   *
*2222*                    *1111*                      *2222*   *
*2222*                  ***1111***                    *2222*   *
*2222*                  *11111111*                    *2222*   *
*2222********************11111111**********************2222*   *
*22211112222222222222211111****1111122222222222222221112222*   *
*22111112222222222222211111****1111122222222222222221112222*   *
*22221112222222222222211111****1111122222222222222221111122*   *
*22221112222222222222211111****1111122222222222222221111222*   *
*2222********************11111111**********************2222*   *
*2222*                  *11111111*                    *2222*   *
*2222*                  ***1111***                    *2222*   *
*2222*                    *1111*                      *2222*   *
*2222*                    *1111*                      *2222*   *
*2222*                    *2222*                      *2222*   *
*2222*                    *2222*                      *2222*   *
*2222*                    *2222*                      *2222*   *
*2222*                    *2222*                      *2222*   *
*2222*                    *2222*                      *2222*   *
*2222*                    *2222*                      *2222*   *
*2222*                    *2222*                      *2222*   *
*2222*                    *2222*                      *2222*   *
*2222*                    *2222*                      *2222*   *
*2222*                    *2222*                      *2222*   *
*2222*                    *2222*                      *2222*   *
*2222*                    *2222*                      *2222*   *
*2222*                    *2222*                      *2222*   *
*2222*                    *2222*                      *2222*   *
*2222*                    *2222*                      *2222*   *
*2222*                    *2222*                      *2222*   *
*2222*                    *2222*                      *2222*   *
*2222*                    *2222*                      *2222*   *
*2222*                    *2222*                      *2222*   *
*2222*                    *1111*                      *2222*   *
*1111*                    *1111*                      *2222*   *
*1111**********************1111************************2222*   *
*2222222222222222222222222211222222222222222222222222222222*   *
*2222222222222222222222222221222222222222222222222222222222*   *
*2222222222222222222222222222222222222222222222222222222222*   *
****************************************************************
